01 01 01 01 01 01 01 01
01 .. .. .. .. .. .. 01
01 .. 0A 0A 0A 0A .. 01
01 .. 0A .. .. 0A .. 01
01 .. 0A .. 7F 0A .. 01
01 .. 0A 0A 0A 0A .. 01
01 .. .. .. .. .. .. 01
01 01 01 01 01 01 01 01